0 0 0 0 0 0 0 0 0 0 0 1 0 0 1 0 0 0 0 0 0 0 0 0 0 0
0 0 0 0 0 0 0 0 0 0 0 1 0 0 1 0 0 0 0 0 0 0 0 0 0 0
1 1 0 0 0 0 0 0 0 0 0 1 1 1 1 0 0 0 1 1 0 0 0 0 1 1
1 1 0 0 0 0 0 0 0 0 0 0 0 0 0 0 0 0 1 1 0 0 0 0 1 1
0 0 0 0 1 1 0 0 0 0 0 0 0 0 0 0 0 0 1 1 1 1 0 0 0 1
0 0 0 0 1 1 0 0 2 2 2 2 0 0 0 0 0 0 1 1 1 1 0 0 0 1
1 1 1 1 1 1 0 0 0 0 0 0 0 0 0 0 0 0 0 0 0 0 0 0 0 0
1 1 1 1 1 1 0 0 0 0 0 0 0 0 0 0 0 0 0 0 0 0 0 0 0 0
0 0 0 0 0 0 0 0 0 0 1 1 0 0 0 0 0 0 4 4 4 4 4 4 0 0
0 0 0 0 0 0 0 0 0 0 1 1 2 2 2 2 0 0 4 4 4 4 4 4 0 0
4 4 4 4 4 4 0 0 4 4 4 4 1 1 1 1 0 0 4 4 0 0 0 0 0 0
4 4 4 4 4 4 0 0 4 4 4 4 1 1 1 1 0 0 4 4 0 0 0 0 0 0
0 0 0 0 0 0 0 0 2 2 4 4 0 0 0 0 0 0 4 4 0 0 0 0 0 0
0 0 0 0 0 0 0 0 2 2 4 4 0 0 0 0 0 0 4 4 2 2 0 0 0 0
1 1 0 0 1 1 1 1 1 1 4 4 4 4 4 4 0 0 4 4 1 1 1 1 0 0
1 1 0 0 1 1 1 1 1 1 4 4 4 4 4 4 0 0 4 4 1 1 1 1 0 0
0 0 0 0 2 2 2 2 2 2 4 4 0 0 1 1 0 0 2 2 2 0 1 1 0 0
0 0 0 0 0 0 0 0 0 0 4 4 0 0 1 1 0 0 2 2 2 0 1 1 0 0
0 0 4 4 4 4 4 4 4 4 4 4 0 0 1 1 1 0 0 0 0 0 1 1 0 0
0 0 4 4 4 4 4 4 4 4 4 4 0 0 1 1 1 0 0 0 0 0 1 1 2 2
0 0 0 0 0 0 0 0 1 1 0 0 0 0 0 0 0 0 0 0 0 0 1 1 1 1
0 0 0 0 0 0 0 0 1 1 0 0 1 1 0 0 0 0 0 0 0 0 1 1 1 1
0 0 1 1 1 1 1 1 1 1 0 0 1 1 0 0 0 0 1 1 0 0 0 0 0 0
0 0 1 1 1 1 1 1 0 0 0 0 0 0 0 0 0 0 1 1 0 0 0 0 0 0
0 0 0 0 0 0 0 0 0 0 0 0 0 0 1 1 1 1 1 1 0 0 0 0 0 0
0 0 0 0 0 0 0 0 0 0 0 0 0 0 1 1 1 1 1 1 0 0 0 0 0 0
EnemyTankLevel_4 6
EnemyTankLevel_3 8
EnemyTankLevel_2 6
EnemyTankLevel_1 0