1 1 1 1 2 0 0 0 0 0 0 1 0 0 1 0 0 0 1 1 0 0 1 1 0 0
1 1 1 1 2 0 0 0 0 0 0 1 0 0 1 0 0 0 1 1 0 0 1 1 0 0
1 1 5 5 5 5 5 5 5 5 0 1 1 1 1 0 0 0 1 1 0 0 0 0 0 0
1 1 5 5 5 5 5 5 5 5 0 0 0 0 0 0 0 0 1 1 0 0 0 0 0 0
5 5 5 5 5 5 5 5 5 5 0 0 0 0 0 0 0 0 0 0 1 1 1 1 0 0
5 5 5 5 5 5 5 5 5 5 0 0 0 0 0 0 0 0 0 0 0 0 1 1 0 0
5 5 5 5 5 5 1 1 5 5 0 0 0 0 0 0 0 0 1 1 0 0 1 1 0 0
5 5 5 5 5 5 1 1 5 5 0 0 0 0 0 0 0 0 1 1 0 0 1 1 0 0
0 0 1 1 1 1 1 1 0 0 5 5 5 5 5 5 1 1 1 1 0 0 1 1 0 0
0 0 1 1 1 1 1 1 0 0 5 5 5 5 5 5 1 1 1 1 0 0 1 1 0 0
0 0 0 0 0 0 1 1 1 1 5 5 5 5 5 5 5 5 2 0 0 0 0 0 0 0
0 0 0 0 0 0 1 1 1 1 5 5 5 5 5 5 5 5 2 0 0 0 0 0 0 0
1 1 1 1 1 1 1 1 5 5 5 5 5 5 5 5 5 5 5 5 5 5 1 1 1 1
1 1 1 1 1 1 1 1 5 5 5 5 5 5 5 5 5 5 5 5 5 5 1 1 1 1
0 0 0 0 0 2 5 5 5 5 5 5 5 5 1 1 0 1 1 0 0 0 0 0 0 0
0 0 0 0 0 2 5 5 5 5 5 5 5 5 1 1 0 1 1 0 0 0 2 2 2 2
5 5 5 5 5 5 5 5 5 5 5 5 1 1 1 1 0 1 1 0 0 0 0 0 0 0
5 5 5 5 5 5 5 5 5 5 5 5 1 1 1 1 0 1 1 0 0 0 0 0 0 0
5 5 5 5 5 5 2 0 1 1 0 0 0 0 1 1 5 5 5 5 5 5 5 5 0 0
5 5 5 5 5 5 2 0 1 1 0 0 0 0 1 1 5 5 5 5 5 5 5 5 0 0
0 0 1 1 0 0 0 0 1 1 0 0 2 2 5 5 5 5 5 5 5 5 5 5 0 0
0 0 1 1 0 0 0 0 1 1 0 0 2 2 5 5 5 5 5 5 5 5 5 5 0 0
0 0 1 1 0 0 1 1 1 1 0 0 0 0 5 5 5 5 5 5 1 1 1 1 0 0
0 0 1 1 0 0 1 1 1 1 0 0 0 0 5 5 5 5 5 5 1 1 1 1 0 0
0 0 0 0 0 0 0 0 1 1 0 0 0 0 0 0 0 0 0 0 1 1 0 0 0 0
0 0 0 0 0 0 0 0 0 0 0 0 0 0 0 0 0 0 0 0 0 0 0 0 0 0
EnemyTankLevel_4 8
EnemyTankLevel_3 2
EnemyTankLevel_2 8
EnemyTankLevel_1 2