2 0 2 0 2 0 0 2 0 0 0 1 0 0 1 0 0 0 2 0 0 2 0 2 0 2
2 0 2 0 2 0 0 2 0 0 0 1 0 0 1 0 0 0 2 0 0 2 0 2 0 2
1 0 1 0 1 0 0 0 0 0 0 1 1 1 1 0 0 0 0 0 0 1 0 1 0 1
1 0 1 0 1 0 0 0 0 0 0 0 0 0 0 0 0 0 0 0 0 1 0 1 0 1
0 2 0 2 0 2 0 0 0 0 0 0 0 0 0 0 0 0 0 0 2 0 2 0 2 0
0 2 0 2 0 2 0 0 0 0 0 0 0 0 0 0 0 0 0 0 2 0 2 0 2 0
0 0 0 0 0 0 0 0 1 0 1 0 1 0 1 0 1 0 0 0 0 0 0 0 0 0
0 0 0 0 0 0 0 0 1 0 1 0 1 0 1 0 1 0 0 0 0 0 0 0 0 0
0 0 0 0 0 0 0 0 0 1 0 1 0 1 0 1 0 1 0 0 0 0 0 0 0 0
0 0 0 0 0 0 0 0 0 1 0 1 0 1 0 1 0 1 0 0 0 0 0 0 0 0
4 4 4 4 4 4 0 0 1 1 1 1 1 1 1 1 1 1 0 0 4 4 4 4 4 4
4 4 4 4 4 4 0 0 1 1 1 1 1 1 1 1 1 1 0 0 4 4 4 4 4 4
3 3 3 3 0 0 0 0 1 1 3 3 1 1 3 3 1 1 0 0 0 0 3 3 3 3
3 3 3 3 0 0 0 0 1 1 3 3 1 1 3 3 1 1 0 0 0 0 3 3 3 3
3 3 0 0 0 0 1 1 1 1 1 1 1 1 1 1 1 1 1 1 0 0 0 0 3 3
3 3 0 0 0 0 1 1 1 1 1 1 1 1 1 1 1 1 1 1 0 0 0 0 3 3
0 0 0 0 0 0 1 1 3 3 3 3 1 1 3 3 3 3 1 1 0 0 0 0 0 0
0 0 0 0 0 0 1 1 3 3 3 3 1 1 3 3 3 3 1 1 0 0 0 0 0 0
0 0 0 0 0 0 1 1 1 1 3 3 1 1 3 3 1 1 1 1 0 0 0 0 0 0
0 0 0 0 0 0 1 1 1 1 3 3 1 1 3 3 1 1 1 1 0 0 0 0 0 0
3 3 0 0 0 0 0 1 1 1 1 1 1 1 1 1 1 1 1 0 0 0 0 0 3 3
3 3 0 0 0 0 0 1 1 1 1 1 1 1 1 1 1 1 1 0 0 0 0 0 3 3
3 3 3 3 0 0 0 0 1 1 1 1 1 1 1 1 1 1 0 0 0 0 3 3 3 3
3 3 3 3 0 0 0 0 0 0 1 1 1 1 1 1 0 0 0 0 0 0 3 3 3 3
0 0 0 0 0 0 0 0 0 0 0 0 0 0 0 0 0 0 0 0 0 0 0 0 0 0
0 0 0 0 0 0 0 0 0 0 0 0 0 0 0 0 0 0 0 0 0 0 0 0 0 0
EnemyTankLevel_4 6
EnemyTankLevel_3 10
EnemyTankLevel_2 4
EnemyTankLevel_1 0