2 2 1 1 1 1 0 0 0 0 0 1 0 0 1 0 0 0 1 1 0 0 0 0 0 0
2 2 1 1 1 1 0 0 0 0 0 1 0 0 1 0 0 0 1 1 0 0 0 0 0 0
1 1 1 1 0 0 2 0 0 0 0 1 1 1 1 0 0 0 3 3 3 3 3 3 0 0
1 1 1 1 0 0 2 0 0 0 0 0 0 0 0 0 0 0 3 3 3 3 3 3 0 0
1 1 0 0 0 0 2 0 0 0 0 0 0 0 0 0 0 0 3 3 3 3 3 3 0 0
1 1 0 0 0 0 2 0 0 0 0 0 0 0 1 1 1 1 3 3 3 3 3 3 0 0
0 0 0 0 0 0 0 0 0 0 0 0 0 0 0 0 1 1 3 3 3 3 3 3 3 3
0 0 0 0 0 0 0 0 0 0 0 0 0 0 0 0 0 0 3 3 3 3 3 3 3 3
1 1 1 0 0 1 1 1 1 0 0 1 0 0 0 0 0 0 3 3 3 3 3 3 3 3
1 1 1 0 0 1 1 1 1 0 0 1 1 1 1 1 1 1 3 3 3 3 3 3 3 3
0 0 1 1 0 0 1 1 0 0 0 0 0 0 0 0 0 0 3 3 3 3 3 3 3 3
0 0 0 0 0 0 0 0 0 0 0 0 0 0 0 0 0 0 3 3 3 3 3 3 3 3
0 0 3 3 0 0 0 0 0 0 0 0 2 2 2 2 2 2 0 0 0 0 3 3 0 0
0 0 3 3 0 0 0 0 0 0 0 0 2 2 2 2 2 2 0 0 0 0 3 3 0 0
3 3 3 3 3 3 3 3 0 0 0 0 1 1 0 0 0 0 0 0 0 0 0 1 0 0
3 3 3 3 3 3 3 3 0 0 0 0 1 1 0 0 0 0 0 0 0 0 0 1 0 0
3 3 3 3 3 3 3 3 1 1 1 1 1 1 0 0 0 0 1 1 0 0 0 1 0 0
3 3 3 3 3 3 3 3 1 1 1 1 1 1 1 1 0 0 1 1 0 0 0 1 0 0
3 3 3 3 3 3 3 3 0 0 0 0 0 0 1 1 0 0 1 1 1 1 1 1 1 0
3 3 3 3 3 3 3 3 0 0 0 0 0 0 1 1 0 0 1 1 1 1 1 1 1 0
1 1 3 3 3 3 3 3 0 0 0 0 0 0 0 0 0 0 0 0 0 0 0 0 0 0
1 1 3 3 3 3 3 3 0 0 0 0 0 0 0 0 0 0 0 0 0 0 0 0 0 0
0 0 3 3 3 3 3 3 1 1 0 0 0 0 0 0 0 0 0 0 2 2 2 2 2 2
0 0 3 3 3 3 3 3 1 1 0 0 0 0 0 0 0 0 0 0 0 0 0 0 0 0
0 0 0 0 0 0 0 0 1 1 0 0 0 0 0 0 1 1 0 0 0 0 0 0 0 0
0 0 0 0 0 0 0 0 1 1 0 0 0 0 0 0 1 1 0 0 0 0 0 0 0 0
EnemyTankLevel_4 2
EnemyTankLevel_3 0
EnemyTankLevel_2 4
EnemyTankLevel_1 14