0 0 0 0 0 0 1 0 0 0 0 1 0 0 1 0 0 0 0 0 1 0 0 0 0 0
0 0 0 0 0 0 1 0 0 0 0 1 0 0 1 0 0 0 0 0 1 0 0 0 0 0
0 0 0 0 3 3 3 3 3 3 0 1 1 1 1 0 3 3 3 3 3 3 3 3 0 0
0 0 0 0 3 3 3 3 3 3 0 0 0 0 0 0 3 3 3 3 3 3 3 3 0 0
1 1 3 3 3 3 3 3 3 3 3 3 3 3 3 3 3 3 3 3 3 3 3 3 1 1
1 1 3 3 3 3 3 3 3 3 3 3 3 3 3 3 3 3 3 3 3 3 3 3 1 1
1 1 3 3 0 0 0 0 0 0 2 2 2 2 0 0 0 0 0 0 0 0 3 3 1 1
1 1 3 3 1 1 1 1 1 1 2 2 2 2 1 1 1 1 1 1 1 1 3 3 1 1
0 0 0 0 1 1 1 1 1 1 1 1 1 1 1 1 1 1 1 1 1 1 1 0 0 0
0 0 0 0 1 1 1 1 1 1 1 1 1 1 1 1 1 1 1 1 1 1 1 0 0 0
0 0 0 0 1 1 1 1 2 2 0 0 1 1 0 0 2 2 1 1 1 1 1 0 0 0
0 0 0 0 1 1 1 1 2 2 0 0 1 1 0 0 2 2 1 1 1 1 1 0 0 0
0 0 1 1 1 1 1 1 2 2 2 2 1 1 2 2 2 2 1 1 1 1 1 1 1 0
0 0 1 1 1 1 1 1 2 2 2 2 1 1 2 2 2 2 1 1 1 1 1 1 1 0
0 1 1 1 1 1 1 1 4 4 4 4 4 4 4 4 4 4 4 4 1 1 1 1 1 1
0 1 0 0 0 0 1 1 4 4 4 4 4 4 4 4 4 4 4 4 1 1 1 1 1 1
1 1 0 0 0 0 0 1 1 1 3 3 2 2 2 2 3 3 1 1 1 0 0 0 1 1
1 1 0 0 0 0 0 1 1 1 3 3 2 2 2 2 3 3 1 1 1 0 0 0 1 1
1 1 0 0 0 0 0 0 1 1 3 3 3 3 3 3 3 3 1 1 0 0 0 0 0 1
1 1 0 0 0 0 0 0 1 1 3 3 3 3 3 3 3 3 1 1 0 0 0 0 0 1
0 1 0 0 0 0 0 0 1 1 0 0 3 3 3 3 0 0 1 1 0 0 0 0 0 1
0 1 1 1 0 0 0 0 1 1 0 0 3 3 3 3 0 0 1 1 0 0 0 0 0 1
0 0 0 1 0 0 1 1 0 0 0 0 0 0 0 0 0 0 0 0 1 1 0 0 1 0
0 0 0 1 1 1 1 1 0 0 0 0 0 0 0 0 0 0 0 0 1 1 1 1 1 0
0 0 0 0 0 0 0 0 0 0 0 0 0 0 0 0 0 0 0 0 0 0 0 0 0 0
0 0 0 0 0 0 0 0 0 0 0 0 0 0 0 0 0 0 0 0 0 0 0 0 0 0
EnemyTankLevel_4 2
EnemyTankLevel_3 4
EnemyTankLevel_2 2
EnemyTankLevel_1 12