0 0 0 0 0 0 0 0 0 0 0 1 0 0 1 0 0 0 0 0 0 0 0 0 0 0
1 1 0 0 0 0 0 0 0 0 0 1 0 0 1 0 0 0 0 0 0 0 0 0 0 0
1 1 1 1 0 0 0 0 0 0 0 1 1 1 1 0 0 0 0 0 1 1 0 0 0 0
1 1 1 1 1 1 0 0 0 0 0 0 0 0 0 0 0 0 1 1 1 1 0 0 0 0
0 0 0 0 0 0 0 0 1 1 0 0 0 0 0 0 1 1 1 1 0 0 0 0 0 0
0 0 0 0 0 0 0 0 1 1 1 1 1 1 1 1 1 1 0 0 0 0 0 0 0 0
0 0 0 0 0 0 1 1 1 1 0 0 0 0 0 0 0 0 0 0 0 2 1 1 1 1
0 0 0 0 0 0 0 0 0 0 0 0 0 0 0 0 0 0 0 0 0 2 1 1 1 1
4 4 4 4 4 4 0 0 4 4 0 0 2 2 0 0 1 1 0 0 0 2 0 0 0 0
4 4 4 4 4 4 0 0 4 4 0 0 2 2 0 0 1 1 0 0 0 2 0 0 0 0
0 0 0 0 0 0 0 0 4 4 0 0 0 0 0 0 0 0 0 0 0 2 2 0 0 0
0 0 0 0 0 0 0 0 4 4 0 0 0 0 0 0 0 0 0 0 0 2 2 0 0 0
1 1 1 1 0 0 0 0 4 4 1 1 0 0 1 1 1 1 0 0 0 0 0 0 0 0
1 1 1 1 0 0 0 0 4 4 1 1 0 0 1 1 1 1 0 0 0 0 0 0 0 0
0 0 0 0 1 1 0 0 4 4 4 4 0 0 4 4 4 4 4 4 0 0 1 1 1 1
0 0 0 0 0 0 0 0 4 4 4 4 0 0 4 4 4 4 4 4 0 0 1 1 1 1
0 0 0 0 0 0 0 0 0 0 0 0 0 0 0 0 0 0 4 4 0 0 0 0 0 0
1 1 0 0 0 0 0 0 1 1 0 0 0 0 0 0 0 0 4 4 0 0 0 0 0 0
1 1 0 0 1 1 1 1 1 1 0 0 1 1 1 1 0 0 4 4 4 4 0 0 4 4
1 1 0 0 1 1 1 1 1 1 0 0 1 1 1 1 0 0 4 4 4 4 0 0 4 4
2 2 0 0 1 1 0 0 0 0 0 0 1 1 0 0 0 0 0 0 0 0 0 0 0 0
2 2 0 0 1 1 0 0 0 0 0 0 1 1 0 0 0 0 0 0 0 0 0 0 0 0
2 2 0 0 1 1 0 0 1 1 0 0 0 0 0 0 0 0 0 0 2 2 0 0 0 0
0 0 0 0 0 0 0 0 1 1 0 0 0 0 0 0 2 2 2 2 2 2 0 0 0 0
0 0 0 0 0 0 0 0 1 1 1 1 0 0 0 0 0 0 0 0 0 0 0 0 0 0
0 0 0 0 0 0 0 0 1 1 1 1 0 0 0 0 0 0 0 0 0 0 0 0 0 0
EnemyTankLevel_4 2
EnemyTankLevel_3 5
EnemyTankLevel_2 5
EnemyTankLevel_1 8