0 0 0 0 0 0 0 0 0 0 0 1 0 0 1 0 0 0 4 4 0 0 3 3 0 0
0 0 0 0 0 0 0 0 0 0 0 1 0 0 1 0 0 0 4 4 0 0 3 3 0 0
0 0 1 1 0 0 1 1 0 0 0 1 1 1 1 0 0 0 4 4 3 3 3 3 3 3
0 0 1 1 0 0 1 1 0 0 0 0 0 0 0 0 0 0 4 4 3 3 3 3 3 3
0 0 1 1 0 0 2 2 0 0 0 0 0 0 0 0 0 0 0 0 3 3 3 3 3 3
0 0 1 1 0 0 0 0 0 0 1 1 1 1 1 1 0 0 0 0 3 3 3 3 3 3
0 0 2 2 0 0 0 0 0 0 1 1 0 0 3 3 0 0 4 4 0 0 3 3 0 0
0 0 0 0 0 0 0 0 0 0 1 1 0 0 3 3 0 0 4 4 0 0 3 3 0 0
0 0 0 0 0 1 0 0 0 0 1 1 3 3 3 3 3 3 4 4 0 0 1 1 0 0
1 1 0 0 0 1 0 0 0 0 1 1 3 3 3 3 3 3 4 4 0 0 1 1 0 0
1 1 1 1 0 1 1 1 0 0 2 2 3 3 3 3 3 3 4 4 0 0 1 1 1 1
1 1 1 1 0 1 1 1 0 0 2 2 3 3 3 3 3 3 4 4 0 0 0 0 0 0
0 0 0 0 0 0 1 1 0 0 0 0 0 0 3 3 0 0 4 4 0 0 0 0 0 0
0 0 0 0 0 0 0 0 0 0 0 0 0 0 3 3 0 0 4 4 0 0 2 2 2 2
1 1 0 0 1 1 4 4 4 4 0 0 4 4 4 4 4 4 4 4 0 0 0 0 1 1
1 1 0 0 1 1 4 4 4 4 0 0 4 4 4 4 4 4 4 4 0 0 0 0 1 1
0 0 0 0 1 1 4 4 0 0 0 0 0 0 1 1 0 0 0 0 0 0 0 0 0 0
0 0 0 0 1 1 4 4 0 0 0 0 0 0 1 1 0 0 0 0 0 0 0 0 0 0
0 0 0 0 1 1 4 4 0 0 2 2 0 0 1 1 0 0 0 0 1 1 0 0 0 0
2 2 0 0 1 1 4 4 0 0 2 2 0 0 0 0 1 1 0 0 1 1 0 0 0 0
0 0 0 0 0 0 4 4 0 0 1 1 2 2 0 0 1 1 0 0 1 1 0 0 0 0
0 0 0 0 0 0 4 4 0 0 0 0 2 2 0 0 1 1 0 0 1 1 0 0 0 0
0 0 0 0 0 0 0 0 0 0 0 0 0 0 0 0 1 1 0 0 2 2 0 0 0 0
0 0 0 0 0 0 0 0 0 0 0 0 0 0 0 0 1 1 0 0 2 2 0 0 0 0
0 0 0 0 0 0 4 4 0 0 1 1 0 0 0 0 1 1 0 0 1 1 0 0 0 0
0 0 0 0 0 0 4 4 0 0 1 1 0 0 0 0 1 1 0 0 1 1 0 0 0 0
EnemyTankLevel_4 8
EnemyTankLevel_3 2
EnemyTankLevel_2 8
EnemyTankLevel_1 2