2 2 3 3 0 0 0 0 0 0 0 1 0 0 1 0 0 0 0 0 3 3 3 3 2 2
2 2 3 3 0 0 0 0 0 0 0 1 0 0 1 0 0 0 0 0 3 3 3 3 2 2
3 3 0 0 0 0 0 0 0 0 0 1 1 1 1 0 0 0 0 0 0 0 3 3 3 3
3 3 0 0 1 1 1 1 0 0 0 0 0 0 0 0 1 1 1 1 0 0 3 3 3 3
0 0 1 1 1 1 1 1 0 0 1 1 1 1 0 0 1 1 1 1 1 1 0 0 3 3
0 0 1 1 1 1 0 0 1 1 1 1 1 1 1 1 0 0 1 1 1 1 0 0 3 3
0 0 0 0 0 0 1 1 1 1 1 1 1 1 1 1 1 1 0 0 0 0 0 0 0 0
0 0 1 1 1 1 1 1 1 1 1 1 1 1 1 1 1 1 1 1 1 1 0 0 0 0
0 0 0 1 1 1 1 1 1 1 1 1 1 1 1 1 1 1 1 1 1 0 0 0 0 0
0 0 0 1 1 1 1 1 1 1 1 1 1 1 1 1 1 1 1 1 1 0 0 0 0 0
0 0 0 0 1 1 1 1 1 1 1 1 1 1 1 1 1 1 1 1 0 0 0 0 0 0
0 0 0 0 1 1 1 1 1 1 1 1 1 1 1 1 1 1 1 1 0 0 0 0 0 0
0 0 0 0 1 1 0 0 1 1 1 1 0 0 0 0 1 1 1 0 0 0 4 4 4 4
0 0 0 0 1 1 0 0 0 0 0 0 0 0 0 0 1 1 1 0 0 0 4 4 4 4
4 4 0 0 0 1 0 0 2 0 0 0 2 0 0 0 1 1 1 0 0 0 0 0 0 0
4 4 0 0 0 1 0 0 2 0 0 0 2 0 0 0 1 1 1 0 0 0 0 0 0 0
0 0 0 0 0 1 0 0 0 0 0 0 0 0 0 0 1 1 1 1 0 0 1 0 0 0
0 0 0 0 0 1 1 1 0 0 0 0 0 0 1 1 1 1 1 1 0 0 1 0 0 0
0 0 0 0 0 0 1 1 1 1 1 1 1 1 1 1 1 1 1 1 1 1 1 0 0 0
2 2 0 0 0 0 1 1 1 1 1 1 1 1 1 1 1 1 1 1 1 1 1 0 0 0
3 3 0 0 0 0 0 1 1 1 1 1 1 1 1 1 1 1 1 1 1 1 0 0 0 0
3 3 0 0 0 0 0 1 1 1 1 1 1 1 1 1 1 1 1 1 0 0 0 0 2 2
3 3 3 3 0 0 0 0 1 1 1 1 1 1 1 1 1 1 0 0 0 0 0 0 3 3
3 3 3 3 0 0 0 0 0 0 1 1 1 1 0 0 0 0 0 0 0 0 0 0 3 3
0 0 3 3 3 3 0 0 0 0 0 0 0 0 0 0 0 0 0 0 0 0 3 3 0 0
0 0 3 3 3 3 0 0 0 0 0 0 0 0 0 0 0 0 0 0 0 0 3 3 0 0
EnemyTankLevel_4 3
EnemyTankLevel_3 10
EnemyTankLevel_2 5
EnemyTankLevel_1 2